........
........
........
.#......
.#.!.+..
.#..%...
.#......
.###.##.
........
........
